
NO ./textures/bluestone.xpm

SO ./textures/colorstone.xpm
WE ./textures/greystone.xpm
EA ./textures/redbrick.xpm


F 124,142, 12
C 12, 220, 125

11111 1111
1N00000001
1111000001
1000000001
1000001001
1000001001
1000001001
1111111111