
NO ./textures/bluestone.xpm

SO ./textures/colorstone.xpm
WE ./textures/greystone.xpm
EA ./textures/redbrick.xpm
S ./textures/pillar.xpm

F 124, 142, 12
C 12, 220, 125

1111111111
1000000001
1111000001
1000000001
1000001001
1000001001
1W00001001
1111111111