

NO ./textures/bluestone.xpm
SO ./textures/colorstone.xpm
WE ./textures/greystone.xpm
EA ./textures/redbrick.xpm

F 135, 245, 251
C 117, 142, 79

1111111111
10000000N1
 111000001
1000000001
1000001001
1000001001
1000001001
1111111111
