

NO ./textures/bluestone.xpm
SO ./textures/colorstone.xpm
WE ./textures/greystone.xpm
EA ./textures/redbrick.xpm

F 135, 245, 251
C 117, 142, 79

1111111111
1000000001
1000000001
10000N0001
10000000011
100000100001
111111111111
